10 10
0 0 0 0 0 0 0 0 0 0 0 0 0 0 0 0 0 0 0 0 0
0 1 1 1 1 1 1 1 1 1 1 1 1 1 1 1 1 1 1 1 0
0 1 0 1 0 1 0 0 0 0 0 0 0 0 0 0 0 0 0 1 0
0 1 0 1 0 1 0 1 1 1 1 1 1 1 1 1 0 1 1 1 0
0 1 0 1 0 1 0 0 0 0 0 0 0 1 0 0 0 1 0 1 0
0 1 0 1 0 1 1 1 0 1 1 1 1 1 0 1 0 1 0 1 0
0 1 0 1 0 0 0 1 0 0 0 1 0 1 0 1 0 1 0 0 0
0 1 0 1 1 1 0 1 1 1 0 1 0 1 1 1 0 1 1 1 0
0 1 0 0 0 0 0 0 0 1 0 1 0 1 0 1 0 0 0 1 0
0 1 1 1 0 1 1 1 0 1 0 1 0 1 0 1 1 1 0 1 0
0 1 0 0 0 1 0 1 0 1 0 1 0 1 0 1 0 1 0 1 0
0 1 0 1 1 1 0 1 1 1 1 1 1 1 0 1 0 1 1 1 0
0 1 0 1 0 0 0 0 0 0 0 0 0 0 0 1 0 1 0 0 0
0 1 1 1 1 1 1 1 1 1 1 1 0 1 0 1 0 1 1 1 0
0 0 0 0 0 0 0 0 0 0 0 1 0 1 0 0 0 1 0 1 0
0 1 1 1 1 1 1 1 1 1 0 1 1 1 1 1 1 1 0 1 0
0 1 0 0 0 0 0 0 0 1 0 0 0 0 0 0 0 0 0 1 0
0 1 1 1 1 1 1 1 1 1 1 1 0 1 1 1 1 1 1 1 0
0 1 0 0 0 0 0 1 0 0 0 1 0 1 0 0 0 0 0 1 0
0 1 0 1 1 1 1 1 1 1 0 1 1 1 1 1 1 1 1 1 0
0 0 0 0 0 0 0 0 0 0 0 0 0 0 0 0 0 0 0 0 0
7 6
2 0
1
1
1 7